0. 0. 0. 0. 0. 0. 0. 0. 0.
0. 0. 0. 0. 0. 0. 0. 0. 0.
0. 0. 0. 0. 0. 0. 0. 0. 0.
0. 0. 0. 0. 0. 0. 0. 0. 0.
0. 0. 0. 0. 0. 0. 0. 0. 0.
0. 0. 0. 0. 0. 0. 0. 0. 0.
0. 0. 0. 0. 0. 0. 0. 0. 0.
S3 0. 2. s2 S2 d2 2. 0. S3
D3 S3 0. P2 P2 P2 0. L3 L3
D3 D3 D3 0. S2 0. D3 P3 P3
L3 S3 L3 D3 0. D3 P3 L3 S3
P3 S3 l3 0. D2 0. D3 S3 l3
p3 S3 0. D2 p2 P2 0. L3 L3
D3 0. D2 S2 S2 L2 L2 0. P3
0. 0. 0. 0. 0. 0. 0. 0. 0.
0. 0. 0. 0. 0. 0. 0. 0. 0.
0. 0. 0. 0. 0. 0. 0. 0. 0.
0. 0. 0. 0. 0. 0. 0. 0. 0.
0. 0. 0. 0. 0. 0. 0. 0. 0.